WWWWWWWWWWWWW
WAAAAAAAAAAAW
WAOOOPOOOOOAW
WAOOOGOOOGOAW
WAOOOOOOOOOAW
WAOEOOOOOLOAW
WAAAOOOOOAAAW
WAEOOOOOOOLAW
WWWWOOKOOWWWW
WWWWWWWWWWWWW