OOOOOOOOOO
OPGOOOOGOO
RROOOOOORO
OOMOnnNRRO
OROOOOOOGO
OOOOGGOOOO
OOUOORRRRR
OOOGOOOOOO
OOOOOGOKOO