RRRRRRRRRRRRRR
ROOOOOOOOOOOOR
ROOOOOOOOOOOOR
ROOOOOLOOOOOOR
ROXXGXXOOSOOOR
ROGOPOXONEOOOR
ROXOOOGOOOKOOR
ROXOOOXSOOOOOR
ROXOOOXEOOOOOR
RSXGXXXXXGXXXR
ROOOOOOOOOOOOR
RRRRRRRRRRRRRR