RRRRRRRRRRRRRR
RPOOONOOOOOOOR
ROOOOOOOOOROOR
REOOOOOROOOOOR
ROOROOOOOOOOOR
ROORRROOOROXOR
ROOOOOOOOOOOOR
ROOOOOOOOOOOOR
RRRRRROOROOOOR
ROOOOROOOROOOR
RYOOOOOOOOOOOR
ROOOOOOOOOOKOR
ROOOOOOOOOOOOR
RRRRRRRRRRRRRR
