WWWWWWWWWWWWWWWWWWWWWWWAAAAAAA
WWWWWWWWWWWWWWWWWWWWWWWAAAAAAA
WWWOOGGOOOGGOOOOOOOOOGGOOOOAAA
WWWOOOOOOOXOOOOOOOXOOOOOPOOAAA
WWWOOOGGOOOOOOOGGOOOOOOOOOOAAA
AAAAAAAAOOOAAAAAAAAAAAAAAAAAAA
AAAAAAAAGOOAAAAAAAAAAAAAAAAAAA
AAAAAAAAGOOAAAAAAAAAAAAAAAAAAA
WWWOOOOOOOOOOOOOOOOOOOOOOOOAAA
WWWOWOOOOOXOOOOOWOOOOOOOOOOAAA
WWWOOOOOOOOOOOOOOOOOOOQOOOOAAA
WWWOOOOWWWWWWOOGGGOOOOOOOOOAAA
WWWOOOOOOWWWOOOOOOOOOOOOOOOAAA
WWWOOOOOOWWWOOOUOOOOGGOOOWOAAA
WWWOOOOOOWWWOOOOOOOOGGOOOOOAAA
WWWOOOOWOWWWOOOOOOOOWWOOOOOAAA
WWWOOOQOOWWWOOOOOOOOOOOOOGGAAA
WWWOOOOOOWWWOOOGGOOOYOOOOGGAAA
WWWOOOOOOWWWOOOGROOOOOOOOGGAAA
WWWOOOOOOWWWOOOOOOOOOOOOOOOAAA
WWWOOOOOOWWWWWOOOOOORROOOOOAAA
WWWOOWOOOWWOOOOOOOOOOOOOOOOAAA
WWWOQOOOOAAOOOOOOOOOOOOOUOOAAA
WWWOOOOOOAAOKOOOSOOOOOOOOOOAAA
WWWWWWWWWWWWWWWWWWWWWWAAAAAAAA
WWWWWWWWWWWWWWWWWWWWWWAAAAAAAA