WWWWWWWWWWWWWWWWWWWWWWWWWWWWWW
WOOBOOOOOOOOOOOOOOOWOOOOKOOOOW
WOOOGGOWOOOOOOOOOOOWEOOOOOOOLW
WOOOOOOWOOOOOOOOOOOWEOOOOOOOLW
WGOOOOBWOOOOOOOOOOOWEOOOOOOOLW
WGOOOOOWOOOOOOOOOOOWEOOOOOOOLW
WOOOOOGWOOGGGOOOOOOWEOOOOOOOLW
WBOOOOGWOOOGOOOOOOOWOOOOOOOOOW
WOOOOOOWOBOOOOOOBOOWOOOOOOOOOW
WOOGGGOWOOOOOOOOOOOWOOOOOmOOOW
WOOOOOOWOOOOOOOOOOOWOOOOOOOOOW
WRRRGRWOOOOOOOGGOOOWOOmOOOOOOW
WUOGOOUWOOOOOOOOOOOWOOOOOOMOOW
WOOGOOOWOGGGOOOGGGOWOOOOOOOOOW
WOOOOOOWRRAAAOAARARWOOOOOOOOOW
WWGGOUOWOOOOOOOOOOOWAAAAAAOTOW
WOOOGOOWOGOOOOOOGOOWOOOOOOQOOW
WOOOGOOWOGOOOBOOGOOWOOOOOOOOOW
WOOOOOOWOOOOOXOOOOOWOOOOOOOOOW
WOOWWWWWOOOOOOOOOOOWOOOOOOOOOW
WOGOOOOWORRAARARAAOWOOOOOOOOOW
WOGOOOOWOOOOOOOOOOOWOTOOOOOOOW
WYGUOOOWOOOGGGOOOOOWQOOOOOOTOW
WUOOOOOWOOOGOXOOOOOWOOOOOOQOOW
WUOOOOOWOOOOOOOOOOOWOOOOOOOOOW
WOEOOOOWOOOOOOOOOOOWOOOOOOOOOW
WOEOOOOWOGOOOOOOOOOWWOOOOOOOOW
WAOOOOOWOGOOOOOOGGOWWOOTOOOOOW
WOPOOOLWBOBOOOOBOOBOOOQOOOOOOW
WWOWWWWWWWWWWWWWWWWWWWWWWWWWWW