WWWWWWWWWWWWWWWWWWWWWWWWWWWWWW
WOOBOOOOOOOOOOOOOOOWOOOOKOOOOW
WOOOGGOWOOOOOOOOOOOWOOOOOOOOOW
WOOOOOOWOOOOOOOOOOOWOOOOOOOOOW
WGOOOOBWOOOOOOOOOOOWOOOOOOOOOW
WGOOOOOWOOOOOOOOOOOWOOOOOOOOOW
WOOOOOGWOOGGGOOOOOOWOOOOOOOOOW
WBOOOOGWOOOGOOOOOOOWOOOOOOOOOW
WOOOOOOWOBOOOOOOBOOWOOOOOOOOOW
WOOGGGOWOOOOOOOOOOOWOOOOOOOOOW
WOOOOOOWOOOOOOOOOOOWOOOOOOOOOW
WAAAGAWOOOOOOOGGOOOWOOOOOOOOOW
WUOGOOUWOOOOOOOOOOOWOOOOOOOOOW
WOOGOOOWOGGGOOOGGGOWOOOOOOOOOW
WOOOOOOWRAAAAOAAAARWOOOOOOOOOW
WWGGOUOWOOOOOOOOOOOWAAAAAAOTOW
WOOOGOOWOGOOOOOOGOOWOOOOOOQOOW
WOOOGOOWOGOOOBOOGOOWOOOOOOOOOW
WOOOOOOWOOOOOXOOOOOWOOOOOOOOOW
WOOWWWWWOOOOOOOOOOOWOOOOOOOOOW
WOGOOOOWOARAARARAAOWOOOOOOOOOW
WOGOOOOWOOOOOOOOOOOWOTOOOOOOOW
WYGUOOOWOOOGGGOOOOOWQOOOOOOTOW
WUOOOOOWOOOGOXOOOOOWOOOOOOQOOW
WUOOOOOWOOOOOOOOOOOWOOOOOOOOOW
WOEOOOOWOOOOOOOOOOOWOOOOOOOOOW
WOEOOOOWOGOOOOOOOOOWWOOOOOOOOW
WAOOOOOWOGOOOOOOGGOWWOOTOOOOOW
WOPOOOLWBOBOOOOBOOBOOOQOOOOOOW
WWOWWWWWWWWWWWWWWWWWWWWWWWWWWW