WWWWWWWWWWWWWWWWWWWWWWWWWWWWWW
WOOBOOOOOOOOOOOOOOOWOOOOKOOOOW
WOOOGGOWOOOOOOOOOOOWOOOOOOOOOW
WOOOOOOWOOOOOOOOOOOWOOOOOOOOOW
WGOOOOBWOOOOOOOOOOOWOOOOOOOOOW
WGOOOOOWOOOOOOOOOOOWOOOOOOOOOW
WOOOOOGWOOGGGOOOOOOWOOOOOOOOOW
WBOOOOGWOOOGOOOOOOOWOOOOOOOOOW
WOOOOOOWOBOOOOOOBOOWOOOOOOOOOW
WOOGGGOWOOOOOOOOOOOWOOOOOOOOOW
WOOOOOOWOOOOOOOOOOOWOOOOOOOOOW
WAAAGAWOOOOOOOGGOOOWOOOOOOOOOW
WUOGOOUWOOOOOOOOOOOWOOOOOOOOOW
WOOGOOOWOGGGOOOGGGOWOOOOOOOOOW
WOOOOOOWAAAAAOAAAAAWOOOOOOOOOW
WWGGOUOWOOOOOOOOOOOWAAAAAAOTOW
WOOOGOOWOGOOOOOOGOOWOOOOOOQOOW
WOOOGOOWOGOOOBOOGOOWOOOOOOOOOW
WOOOOOOWOOOOOYOOOOOWOOOOOOOOOW
WOOWWWWWOOOOOOOOOOOWOOOOOOOOOW
WOGOOOOWOAAAAAAAAAOWOOOOOOOOOW
WOGOOOOWOOOOOOOOOOOWOTOOOOOOOW
WXGUOOOWOOOGGGOOOOOWQOOOOOOTOW
WUOOOOOWOOOGOYOOOOOWOOOOOOQOOW
WUOOOOOWOOOOOOOOOOOWOOOOOOOOOW
WOEOOOOWOOOOOOOOOOOWOOOOOOOOOW
WOEOOOOWOGOOOOOOOOOWWOOOOOOOOW
WAOOOOOWOGOOOOOOGGOWWOOTOOOOOW
WOPOOOLWBOBOOOOBOOBOOOQOOOOOOW
WWOWWWWWWWWWWWWWWWWWWWWWWWWWWW