WWWWWWWWWWWWWWWWWWWWWWWWWWWWWW
WOOBOOOOOOOOOOOOOOOWOOOOKOOOOW
WOOOGGOWOOOOOOOOOOOWOOOOOOOOOW
WOOOOOOWOOOOOOOOOOOWOOOOOOOOOW
WGOOOOBWOOOOOOOOOOOWOOOOOOOOOW
WGOOOOOWOOOOOOOOOOOWOOOOOOOOOW
WOOOOOGWOOGGGOOOOOOWOOOOOOOOOW
WBOOOOGWOOOGOOOOOOOWOOOOOOOOOW
WOOOOOOWOBOOOOOOBOOWOOOOOOOOOW
WOOGGGOWOOOOOOOOOOOWmOOOOOOOOW
WOOOOOOWOOOOOOOOOOOWOOOOOmOOOW
WRRRGRWOOOOOOOGGOOOWOOOOOOOOOW
WUOGOOUWOOOOOOOOOOOWOOMOOOOOOW
WOOGOOOWOGGGOOOGGGOWOOOOOOOOOW
WOOOOOOWRAAAAOAARARWOOOOOOOOOW
WWGGOUOWOOOOOOOOOOOWAAAAAAOTOW
WOOOGOOWOGOOOOOOGOOWOOOOOOQOOW
WOOOGOOWOGOOOBOOGOOWOOOOOOOOOW
WOOOOOOWOOOOOXOOOOOWOOOOOOOOOW
WOOWWWWWOOOOOOOOOOOWOOOOOOOOOW
WOGOOOOWOARAARARAAOWOOOOOOOOOW
WOGOOOOWOOOOOOOOOOOWOTOOOOOOOW
WYGUOOOWOOOGGGOOOOOWQOOOOOOTOW
WUOOOOOWOOOGOXOOOOOWOOOOOOQOOW
WUOOOOOWOOOOOOOOOOOWOOOOOOOOOW
WOEOOOOWOOOOOOOOOOOWOOOOOOOOOW
WOEOOOOWOGOOOOOOOOOWWOOOOOOOOW
WAOOOOOWOGOOOOOOGGOWWOOTOOOOOW
WOPOOOLWBOBOOOOBOOBOOOQOOOOOOW
WWOWWWWWWWWWWWWWWWWWWWWWWWWWWW