OOOOOOOOOO
OPGOOOOGOO
RROOOOOORO
OOMOnnNRRO
OROOOOOOOO
OOOOGGOOOO
OOUOORRRRR
OOOGOOOOOO
OOOOOGOKOO