RRRRRRRRRRRRRRRRRRRRRRRRRR
RAAAAAAAAAAAAAAAAAAAAAAAAR
RAAAAAAAAAAAAAAAAAAAAAAAAR
RAAAAAOOOOOOOOOOOOOOOOOAAR
RAAAAOOOOGOOOOOOGOOOOOOAAR
RAAOOGOOOORGGGOROOOOOOOAAR
RAAOOOOOOOROOOOROOOOOOOAAR
RAAOOOWWWWROOOOROOOOOOOAAR
RAAOOGOOOWROOOOROOOOOOOAAR
RAAOOGOOUWAOOOOAOBOOOOOAAR
RAAOOOWWWWAOOOOAOOOOOOOAAR
RAAOORRRAAROOOORAARRROOAAR
RAAOOOOGGOOOOPGOOOOOOGOAAR
RAAOBOOOOOOOOGGOOOOOOOOAAR
RAAOOOOOOOOOOOOOOOGGOOOAAR
RAAUURRRRAAROOORAARRRUUAAR
RAAOOWWWWWWAOOOAOOOOOOOAAR
RAAOOOOOOOWAOOOAOOOOOOOAAR
RAAOOOOOKOWROOOROOOOOOOAAR
RAAOOOOOOOWROOOROOOOOOOAAR
RAAOOWWWWWWROBOROOOOOOOAAR
RAAOOOOOOOOOOOOOOOOOOOOAAR
RAAOOOOOOOOOOOOOOOOOOOOAAR
RAAAAAAAAAAAAAAAAAAAAAAAAR
RAAAAAAAAAAAAAAAAAAAAAAAAR
RRRRRRRRRRRRRRRRRRRRRRRRRR