AAAAAAAAAAAAAAAAAAAAAAAAAA
AOOGGAOOOOOOOOGGOOOOOOOOOA
AOOOOAOOOOOOAOOOOAOOOOOPOA
AOOOOAOOOOOQOOOOQOOOOOOOOA
AAAAAAOOOROAAAAAAAAAAAAAAA
AAAAAAGOQOOAAAAAAAAAAAAAAA
AAAAAARGRAAAAAAAAAAAAAAAAA
AOOOOROOOROOOOOOOOOOOOOOOA
AOWOOGOKOROOOOOOOOOOOOOOOA
AOOOORRRRROQOQOQOQOQOQOOOA
AOOOOOOOOOGGOGOGOGOGOGOGOA
AAAAAAAAAAAAAAAAAAAAAAAAAA