ROOXOOOOOOUOAARAAO
OAAAAAAAAANEOOOOAO
OAPOGOOOOOOOOOOOAO
OAOOOOOUOOOOUOYOAU
AAOOROOOOOOOOOOOAO
AAOQGOGOOGGOGOOGAO
UAOOOOOGOOOOOOOOAO
OAAAAAAAAAOOOGOOAO
ROUOOOUOGOUOOOOGAU
AOOOOGOOGOEOOORGAO
AOOGOOGOOOGGOOOOAO
AKOOUOOOOGOOOOOOAU
AAAAAAAAAAURRRRRRR