RRRRRRRRR
RROOLOORR
RROSQEORR
RRUNXNURR
RRYOOOQRR
RROOPOORR
RROOOOLRR
RROOOOORR
RROOOOORR
RROOOOORR
RAOOOOOAR
RAOOOOOAR
RAOOOOOAR
RAOOOOOAR
RAOOOOOAR
RAOOOOOAR
RAOOOOOAR
RAOOOOOAR
RAOOOOOAR
RAOOOOOAR
RAOOOOOAR
RAOOOOOAR
RAOOOOOAR
RAOOOOOAR
RAOOOOOAR
RAOOOOOAR
RAOOOOOAR
RAOOOOOAR
RAOOOOOAR
RAOOOOOAR
RAOOOOOAR
RAOOOOOAR
RAOOOOOAR
RAOOOOOAR
RAOOOOOAR
RAOOOOOAR
RAOOOOOAR
RAOOOOOAR
RAOOOOOAR
RAOOOOOAR
RAOOOOOAR
RAOOOOOAR
RAOOOOOAR
RAOOOOOAR
RAOOOOOAR
RAOOOOOAR
RAOOOOOAR
RAOOOOOAR
RAOOOOOAR
RAOOOOOAR
RAOOOOOAR
RAOOOOOAR
RAOOOOOAR
RAOOOOOAR
RAOOOOOAR
RAOOOOOAR
RAOOOOOAR
RAOOOOOAR
RAOOOOOAR
RAOOOOOAR
RAOOOOOAR
RAOOOOOAR
RAOOOOOAR
RAOOOOOAR
RAOOOOOAR
RAOOOOOAR
RAOOOOOAR
RAOOOOOAR
RAOOOOOAR
RAOOOOOAR
RAOOOOOAR
RAOOOOOAR
RAOOOOOAR
RAOOOOOAR
RAOOOOOAR
RAOOOOOAR
RAOOOOOAR
RAOOOOOAR
RAOOOOOAR
RAOOOOOAR
RAOOOOOAR
RAOOOOOAR
RAOOOOOAR
RAOOOOOAR
RAOOOOOAR
RAOOOOOAR
RAOOOOOAR
RAOOOOOAR
RAOOOOOAR
RAOOOOOAR
RAOOOOOAR
RAOOOOOAR
RAOOOOOAR
RAOOOOOAR
RAOOOOOAR
RAOOOOOAR
RAOOOOOAR
RAOOOOOAR
RAOOOOOAR
RAOOOOOAR
RAOOOOOAR
RAOOOOOAR
RAOOOOOAR
RAOOOOOAR
RAOOOOOAR
RAOOOOOAR
RAOOOOOAR
RAOOOOOAR
RAOOOOOAR
RAOOOOOAR
RAOOOOOAR
RAOOOOOAR
RAOOOOOAR
RAOOOOOAR
RAOOOOOAR
RAOOOOOAR
RAOOOOOAR
RAOOOOOAR
RAOOOOOAR
RAOOOOOAR
RAOOOOOAR
RAOOOOOAR
RAOOOOOAR
RAOOOOOAR
RAOOOOOAR
RAOOOOOAR
RAOOOOOAR
RAOOOOOAR
RAOOOOOAR
RAOOOOOAR
RAOOOOOAR
RAOOOOOAR
RAOOOOOAR
RAOOOOOAR
RAOOOOOAR
RAOOOOOAR
RAOOOOOAR
RAOOOOOAR
RAOOOOOAR
RAOOOOOAR
RAOOOOOAR
RAOOOOOAR
RAOOOOOAR
RAOOOOOAR
RAOOOOOAR
RAOOOOOAR
RAOOOOOAR
RAOOOOOAR
RAOOOOOAR
RAOOOOOAR
RAOOOOOAR
RAOOOOOAR
RAOOOOOAR
RAOOOOOAR
RAOOOOOAR
RAOOOOOAR
RAOOOOOAR
RAOOKOOAR
RAOOOOOAR
AAAAAAAAA
AAAAAAAAA
AAAAAAAAA
AAAAAAAAA