OOOOOOOOOOOO
OOOOOOOOOOOO
OOOOOLOOOOOO
OXXGXXOOSOOO
OGOPOXONEOOO
OXOOOGOOOKOO
OXOOOXSOOOOO
OXOOOXEOOOOO
SXGXXXXXGXXX
OOOOOOOOOOOO