OOGGOOOOOOOOOOOOOOWOOOOO
OOOOOOOOOOOOOOOOOOOOOPOO
OOOOOOOOOOOOOOOOOOOOOOOO
AAAAAOOOAAAAAAAAAAAAAAAA
AAAAAGOOAAAAAAAAAAAAAAAA
AAAAAGOOAAAAAAAAAAAAAAAA
OOOOOOOOOOOOOOOOOOOOOOOO
OWOOOOOXOOOOOWOOOOOOOOOO
OOOOOOOOOOOOOOOOOOOQOOOO
OOOOWWWWWWOOGGGOOOOOOOOO
OOOOOOWWWOOOOOOOOOOOOOOO
OOOOOOWWWOOOUOOOOGGOOOWO
OOOOOOWWWOOOOOOOOGGOOOOO
OOOOWOWWWOOOOOOOOWWOOOOO
OOOQOOWWWOOOOOOOOOOOOOGG
OOOOOOWWWOOOGGOOOYOOOOGG
OOOOOOWWWOOOGROOOOOOOOGG
OOOOOOWWWOOOOOOOOOOOOOOO
OOOOOOWWWWWOOOOOORROOOOO
OOWOOOWWOOOOOOOOOOOOOOOO
OQOOOOWWOKOOOOOOOOOOOUOO
OOOOOOWWOOOOOSOOOOOOOOOO