XXXXXXXXX
XOOOOXPOX
XOOOOXOOX
XXOOOOOOX
XOOOOOOOX
XOOSOOOLX
XOOOOOOOX
XOEOOOOXX
XOOOOOOOX
XSXKXEOOX
XXXXXXXXX