WWWWWWWWWWWWWWWWWWWWWW
WOOOOOOOOOOROOROOOOOKW
WOOOOOOOOOOROOROWOOOOW
WOOOOOOOGGGGOSROWWWWWW
WOOOOGGRGOORORROGOOOOW
WOOUOGOOGOONGOOOGOOUOW
WOOOOGOOOUOOOOOOGOOOOW
WOGGGGAAAAAAAAOOGOOOOW
WOOOORAOOOOOOARRRRRRRW
WAOOORAOOOOOOAAAGOOOOW
WAGOOUAOOPOOOOOOUOOOOW
WOGOORAOOOOOOAOAOGOOOW
WOOOORAOOOOOOAOAGOOOOW
WGOOURAAAAAAAAOAOGOOOW
WOOOOOOOOUOOOGOAOOOOOW
WOOGGGOOGOOGAAOUOOOOOW
WOWWWWWWWWWWWWWOWWWWWW
WOOOOWOOOOOOOOWOOOOOOW
WOOOOWOOOOOOOOWOOOOOOW
WOOOOWOOOOOOOOWOOLOOOW
WOOOUWOOOOOOOOWOOOOOUW
WWWWWWWWWWWWWWWWWWWWWW