WWWWWWWWW
WOOOOOOOW
WOOOPOOOW
WOOGOOOOW
WOOGOGOOW
WOOOOGOOW
WOOOOOOOW
WOYOOOOGW
WOOOOOOOW
WOUOOGOOW
WOOOGGOOW
WOOOOOOOW
WOOOXOOOW
WGRRRRYGW
WOOOGGOOW
WOOOmOOOW
WGOOGORRW
WOMOOnOOW
WOOGGUOOW
WOOOGNOOW
WRRRRROOW
WOOOOROOW
WOKOORGOW
WOOOOOOOW
WOOOOOOOW
WWWWWWWWW