WWWWWWWWWWWW
WOOOOOOOOOOW
WOPGOOOOGOOW
WRROOOOOOROW
WOOMOnnNRROW
WOROOOOOOGOW
WOOOOGGOOOOW
WOOUOORRRRRW
WOOOGOOOOOOW
WOOOOOGOKOOW
WWWWWWWWWWWW