WWWWWWWWWWWWW
WAAAAAAAAAAAW
WAOOOOPOOOOAW
WAOOOOOOOOOAW
WAOOOOOGGOOAW
WAOOOOXOOOOAW
WAOOOOOOGGOAW
WAOOGOOOOOOAW
WAOOGOOGGOOAW
WAOXOOOOOOOAW
WAOOOGGOOOOAW
WAOOOOOOOGOAW
WAOOOOOOOGOAW
WAOOOOOOOXOAW
WAOGGOOOOOOAW
WAOOOOOOOGGAW
WAOOXOOOOOOAW
WAOOOOGGOOOAW
WAOGGOOOOOOAW
WAOOOOOOOXOAW
WAOOGOOOOOOAW
WAOOGOOOOGGAW
WAOOOOOOOOOAW
WAOGGOOOOOOAW
WAOOOOKOOOOAW
WAAAAAAAAAAAW
WWWWWWWWWWWWW