RRRRRRRRRRRRRRRRRRRRRRRRRR
ROOGGAOOOOOOOOGGOOOOOOOOOR
ROOOOAOOOOOOAOOOOAOOOOOPOR
ROOOOAOOOOOQOOOOQOOOOOOOOR
RAAAAAOOOROAAAAAAAAAAAAAAR
RAAAAAGOQOOAAAAAAAAAAAAAAR
RAAAAARGRAAAAAAAAAAAAAAAAR
ROOOOROOOROOOOOOOOOOOOOOOR
ROWOOGOKOROOOOOOOOOOOOOOOR
ROOOORRRRROQOQOQOQOQOQOOOR
ROOOOOOOOOGGOGOGOGOGOGOGOR
RRRRRRRRRRRRRRRRRRRRRRRRRR