RRRRRRRRRRRRRRRRRRR
AAOOWWOOAAAOOOOOOAA
AAOOOOOOOOOOOOOOOAA
AAOPOOOOOOOOOOOOOAA
AAOOOOOOAAAOOOOOLAA
AAOOOOBOAAAOOOOOOAA
AAAAAAAAAAAAAAAOOAA
AAAAAAAAAAAAAAAOOAA
AAAAAAAAAAAAAAAOOAA
AAOOOOOOOOOOOOBOOAA
AAKOOOOOUOOOOOOOOAA
AAOOOOOGGOOOOOOOOAA
RRRRRRRRRRRRRRRRRRR