OOOOOOOO
OOPOOOOO
OOOOOOOO
OOOOOOOO
OOOFOOOO
OOOOOOOO
OOROOOOO
XXXXOOOO
OOKOOOOO
OOOOOOOO