OOOOOOORRR
OROOOOORNR
OOOOOOOROR
OOROOOOGGG
OOGOPOROOL
OOOOOOOGGO
AAOAAWWWOW
OOOOOWOOOO
OOOOOWOOKO
OOOOOWOOOO