AAAAAAAAAAAAAAAAA
AAAAAAAAAAAAAAAAA
AAAAAAAAAAAAAAAAA
AAAAAAAAAAAAAAAAA
AAAAAAOOOOOAAAAAA
AAAAAOOOOOOOAAAAA
AAAAAOOOPOOOAAAAA
AAAAAOOOOOOOAAAAA
AAAAAOOOOOOOAAAAA
AAAWWWWGGGWWWWAAA
AAAWOOOOOOOOOWAAA
AAAWOOOOGOOSOWAAA
AAAWOSOOOOOOOWAAA
AAAWOOOOOGOOOWAAA
AAAWOOOOOOOOOWAAA
AAAWOOSOOOOOOWAAA
AAAWOOOOOGOSOWAAA
AAAWOOOOOGOOOWAAA
AAAWWWWGGGWWWWAAA
AAAAAOOOOOOOAAAAA
AAAAAOOOOOOOAAAAA
AAAAAOOOKOOOAAAAA
AAAAAOOOOOOOAAAAA
AAAAAAOOOOOAAAAAA
AAAAAAAAAAAAAAAAA
AAAAAAAAAAAAAAAAA
AAAAAAAAAAAAAAAAA
AAAAAAAAAAAAAAAAA