OOOOOAOOOO
OONOOAOOOO
OAGGGGOPOO
GGOOOOOOOO
OOOOSAAAOO
SOSSOOOAAA
OOAOOOOOOO
GALAOOOOOO
OOAOGOGOKO
OOOOOSOOOO