WWWWWOOOGOOOOOGWWWWW
WUUUWOOOOGOOOOOWOOOW
WUUUWOOUOGOGOOOWOOOW
WWGWWGOLOOOOOOOWWOWW
OOOOOOOAAAOOOOOROOOO
OOOOOOOASAOOOOOROOOO
OOOUOOOAAAOOOOOROOBO
OOOOOOOOOOOOOOOOOROU
OUOOOOOOOOOOOOOGOOOO
OOOOOOOOOOOOOOOGOOOO
OOOOBOOOOOOOOOGOOUOO
OOOOOOOOOOOOOOOOOOOO
RRRROOOOOOOOOOOGOOOO
EOOOOGGOROOOOOOGOOOO
OGOUOOOOROOOOOOGRRRR
OGOOOOOGGOOOOOOOOOOO
OOOOGOOOROOBOOOOOOOO
OOOOGGOOROUOORRRRRRR
OPOOGOOOAAAAAAAAAAAA
OOOOOUOOAAAAAAAAAAAA