OOOOOOKSOOOOO
OOXOOOOPOOOOO
OOOOGGGGGOOOO
OOOOGGZGGOOOO
OOOOOOOOOOOOO