OOOOOAOOOO
OONOOAOOOO
OAGGGGOPOO
GGOOOOOOOO
OOOOSAAAOO
SOSSOOOAAA
OOAOOOOOOO
GALOGOGOOO
OOAOGOGOKO
OOOOGSGOOO