AAAAAAAAAAAAAAAAAAAAAAAA
AAAAAAAAAAAAAAAAAAAAAAAA
RWWWWWOOOGOOOOOGWWWWWAAA
RWUUUWOOOOGOOOOOWOKOWAAA
RWUUUWOOUOGOGOOOWOOOWAAA
RWWGWWGOLOOOOOOOWWOWWAAA
ROOGOOOOAAAOOOOOROOOOAAA
ROOOOOOOASAOOOOOROOOOAAA
ROOOUOOOAAAOOOOOROOBOAAA
ROOOOOOOOOOOOOOOOOROUAAA
ROUOOOOOOOOOOOOOGOOOOAAA
ROOOOOOOOOOOOOOOGOOOOAAA
ROOOOBOOOOOOOOOGOOUOOAAA
ROOOOOOOOOOOOOOOOOOOOAAA
RRRRROOOOOOOOOOOGOOOOAAA
REOOOOGGOROOOOOOGOOOOAAA
ROGOUOOOOROOOOOOGRRRRAAA
ROGOOOOOGGOOOOOOOOOOOAAA
ROOOOGOOOROOBOOOOOOOOAAA
ROOOOGGOOROUOORRRRRRRAAA
ROPOOGOOOAAAAAAAAAAAAAAA
ROOOOOUOOAAAAAAAAAAAAAAA
RRRRRRRRRRRRRRRRRRRRRAAA