AAAOOOOOOOOOOOOOOOOO
AAOOOOGOOOOOOGOOOOOO
OOGOOOORGGGOROOOOOOO
OOOOOOOROOOOROOOOOOO
OOOWWWWROOOOROOOOOOO
OOGOOOWROOOOROOOOOOO
OOGOOUWAOOOOAOBOOOOO
OOOWWWWAOOOOAOOOOOOO
OORRRAAROOOORAARRROO
OOOOGGOOOOPGOOOOOOGO
OBOOOOOOOOGGOOOOOOOO
OOOOOOOOOOOOOOOGGOOO
UURRRRAAROOORAARRRUU
OOWWWWWWAOOOAOOOOOOO
OOOOOOOWAOOOAOOOOOOO
OOOOOKOWROOOROOOOOOO
OOOOOOOWROOOROOOOOOO
OOWWWWWWROBOROOOOOOO
OOOOOOOOOOOOOOOOOOOO
OOOOOOOOOOOOOOOOOOOO