XXXXXXXX
XOOOOOOX
XOOPOOOX
XOOOOOOX
XOOOOOOX
XOOOOOOX
XOOOOOOX
XOXOXXOX
XOXOOXOX
XOXKOXOX
XOXOOXOX
XXXXXXXX