OOOOOOOOOOOOOOOOOOOOOOOO
OOPOOOOOOOOOOOOOOOOOOOOO
OOOOOOOOOOOOOOOOOOOOOOOO
AAAAAAAAAAAAAAAAOOOAAAAA
AAAAAAAAAAAAAAAAOOOAAAAA
AAAAAAAAAAAAAAAAOOOAAAAA