OOOOOOOOOOROOROOOOOK
OOOOOOOOOOROOROWOOOO
OOOOOOOGGGGOSROWWWWw
OOOOGGRGOORORROGOOOO
OOUOGOOGOONGOOOGOOUO
OOOOGOOOOOOOOOOGOOOO
OOGGGAAAAAAAAOOGOOOO
OOOORAOOOOOOARRRRRRR
OOOORAOOOOOOAOOGOOOO
OOOOOAOOPOOOOOOGOUOO
OOOORAOOOOOOAOOOGOOO
OOOORAOOOOOOAOOGOOOO
OOOORAAAAAAAAOOOGOOO
OOOOOOOOOOOOOOOOOOOO
OOOOOOOOOOOOOOOOOOOO
OWWWWWWWWWWWWWOWWWWW
OOOOWOOOOOOOOWOOOOOO
OOOOWOOOOOOOOWOOOOOO
OOOOWOOOOOOOOWOOLOOO
OOOUWOOOOOOOOWOOOOOU