AAAAAAAAAAAAAAAAAAAAAAAAAA
AOOGGOOOOOOOOOGGOOOOOOOOOA
AOOOOOOOOOOOAOOOOAOOOOOPOA
AOOOOOOOOOOQOOOOQOOOOOOOOA
AAAAAAOOOROAAAAAAAAAAAAAAA
AAAAAAGOQOOAAAAAAAAAAAAAAA
AAAAAAGOOAAAAAAAAAAAAAAAAA
AOOOOOOOOOOOOOOOOOOOOOOOOA
AOWOOOOOXOOOOOWOOOOOOOOOOA
AOOOOOOOOOOOOOOOOOOOQOOOOA
AOOOOWWWWWWOOGGGOOOOOOOOOA
AOOOOOOWWWOOOOOOOOOOOOOOOA
AOOOOOOWWWOOOUOOOOGGOOOWOA
AOOOOOOWWWOOOOOOOOGGOOOOOA
AOOOOWOWWWOOOOOOOOWWOOOOOA
AOOOQOOWWWOOOOOOOOOOOOOGGA
AOOOOOOWWWOOOGGOOOYOOOOGGA
AOOOOOOWWWOOOGROOOOOOOOGGA
AOOOOOOWWWOOOOOOOOOOOOOOOA
AOOOOOOWWWWWOOOOOORROOOOOA
AOOWOOOWWOOOOOOOOOOOOOOOOA
AOQOOOOWWOKOOOOOOOOOOOUOOA
AOOOOOOWWOOOOOSOOOOOOOOOOA
AAAAAAAAAAAAAAAAAAAAAAAAAA