OOOOOOOOOOROOROOOOOK
OOOOOOOOOOROOROWOOOO
OOOOOOOGGGGOSROWWWWW
OOOOGGRGOORORROGOOOO
OOUOGOOGOONGOOOGOOUO
OOOOGOOOUOOOOOOGOOOO
OGGGGAAAAAAAAOOGOOOO
OOOORAOOOOOOARRRRRRR
AOOORAOOOOOOAAAGOOOO
AGOOUAOOPOOOOOOUOOOO
OGOORAOOOOOOAOAOGOOO
OOOORAOOOOOOAOAGOOOO
GOOURAAAAAAAAOAOGOOO
OOOOOOOOUOOOGOAOOOOO
OOGGGOOGOOGAAOUOOOOO
OWWWWWWWWWWWWWOWWWWW
OOOOWOOOOOOOOWOOOOOO
OOOOWOOOOOOOOWOOOOOO
OOOOWOOOOOOOOWOOLOOO
OOOUWOOOOOOOOWOOOOOU