OOOOOAOOOO
OOOROAOOOO
OROGGGOPOO
OGOOOOOOOO
OOOOSAOOOO
SOOORAAAAA
OOOORNOOOO
OGOOOGGOOO
OOOOOWOOKO
OOOOOWOOOO