OOOPOOOOO
OOOGOOOGO
OOOOOOOOO
OEOOOOOLO
AAOOOOOAA
EOOOOOOOL
WWOOKOOWW
WWWWWWWWW