OOOOOAOOOO
OOOROAOOOO
OROGOOOPOO
OGOOOOOOOO
OOOOOAOOOO
SOOORAAAAA
OOOORNOOOO
OGOOOGOOOO
OOOOOWOKOO
OOOOOWOOOO