ROOXOOOOOOUOAARAAO
OAAAAAAAAANEOOOOAO
OAPOGOOOOOOOOOOOAO
OAOOOOOUOOOOUOYOAU
AAOOROOOOOOOOOOOAO
AAOQGOGOOGOGGOOGAO
UAOOOOOGOOOOOOOOAO
OAAAAAAAAAOOOGOOAO
ROUOOOUOGOUOOOOOAU
AOOOOOOOGOEOOORGAO
AOOGOOGOOOGOOOOOAO
AKOOUOOOOOOOOOOOAU
AAAAAAAAAAURRRRRRR