AAAAAAAAAAAAAAAAA
AAAAAAAAAAAAAAAAA
AAAAAAAAAAAAAAAAA
AAAAAAAAAAAAAAAAA
AAAAAAOOOOOAAAAAA
AAAAAOOOOOOOAAAAA
AAAAAOOOPOOOAAAAA
AAAAAOOOOOOOAAAAA
AAAAAOOOOOOOAAAAA
AAAWWWWGGGWWWWAAA
AAAWOOOOOOOOOWAAA
AAAWOOOOGOOSOWAAA
AAAWOSOOOOOOOWAAA
AAAWOOOOOGOOOWAAA
AAAWOOOOOOOOOWAAA
AAAWOOSOOOOOOWAAA
AAAWOOOOOGOSOWAAA
AAAWOOOOOGOOOWAAA
AAAWOOOOOOOOOWAAA
AAAWOOSOOOOGOWAAA
AAAWOOOOOOOOOWAAA
AAAWOOOOOSOOOWAAA
AAAWOOGOOOOOGWAAA
AAAWOOOOOOOOOWAAA
AAAWGOOOGOOOOWAAA
AAAWGOSOOOOGOWAAA
AAAWOOOOOOOOOWAAA
AAAWOGOOSOOSOWAAA
AAAWOOWWOOOOOWAAA
AAAWOOOWOWWOOWAAA
AAAWOOOOOOOOOWAAA
AAAWWWWGGWWOOWAAA
AAAWOOOOOWOOOWAAA
AAAWOOOOSWWOOWAAA
AAAWOSOOOOOOOWAAA
AAAWOOOOOSOOGWAAA
AAAWOOOOOOOOGWAAA
AAAWOOGOOOOOOWAAA
AAAWOOOOOOOWOWAAA
AAAWGOWOGOOOOWAAA
AAAWGOOOOOOOWWAAA
AAAWOOSOOOOOOWAAA
AAAWOOOOOWWOOWAAA
AAAWOGOOSOOSOWAAA
AAAWOOOGOOOOOWAAA
AAAWWWWGGGWWWWAAA
AAAAAOOOOOOOAAAAA
AAAAAOOOOOOOAAAAA
AAAAAOOOKOOOAAAAA
AAAAAOOOOOOOAAAAA
AAAAAAOOOOOAAAAAA
AAAAAAAAAAAAAAAAA
AAAAAAAAAAAAAAAAA
AAAAAAAAAAAAAAAAA
AAAAAAAAAAAAAAAAA