OOOOOOOOOOOOOOOOOOOOOOOO
OOOOOOOOOOOOOOOOOOOOOPOO
OOOOOOOOOOOOOOOOOOOOOOOO
AAAAAOOOAAAAAAAAAAAAAAAA
AAAAAOOOAAAAAAAAAAAAAAAA
AAAAAOOOAAAAAAAAAAAAAAAA
OOOOOOOOOOOOOOOOOOOOOOOO
OWOOOOOXOOOOOWOOOOOOOOOO
OOOOOOOOOOOOOOOOOOUOOOOO
OOOOWWWWWWOOGGGOOOOOOOOO
OOOOOOWWWOOOOOOOOOOOOOOO
OOOOOOWWWOOOUOOOOGGOOOWO
OOOOOOWWWOOOOOOOOGGOOOOO
OOOOWOWWWOOOOOOOOWWOOOOO
OOOOOOWWWOOOOOOOOOOOOOGG
OOOOOOWWWOOOGGOOOYOOOOGG
OOOOOOWWWOOOGROOOOOOOOGG
OOOOOOWWWOOOOOOOOOOOOOOO
OOOOOOWWWWWOOOOOORROOOOO
OOOOOOWWOOOOOOOOOOOOOOOO
OOOOOOWWOKOOOOOOOOOOOUOO
OOOOOOWWOOOOOSOOOOOOOOOO