OOWWOOAAAOOOOOO
OOOOOOOOOOOOOOO
OPOOOOOOOOOOOOO
OOOOOOAAAOOOOOL
OOOOBOAAAOOOOOO
AAAAAAAAAAAAAOO
AAAAAAAAAAAAAOO
AAAAAAAAAAAAAOO
OOOOOOOOOOOOBOO
KOOOOOUOOOOOOOO
OOOOOGGOOOOOOOO