RRRRRRRRRRRRRRRRRRRR
RROOXOOOOOOUOAARAAOR
ROAAAAAAAAANEOOOOAOR
ROAPOGOOOOOOOOOOOAOR
ROAOOOOOUOOOOUOYOAUR
RAAOOROOOOOOOOOOOAOR
RAAOQGOGOOGGOGOOGAOR
RUAOOOOOGOOOOOOOOAOR
ROAAAAAAAAAOOOGOOAOR
RROUOOOUOGOUOOOOGAUR
RAOOOOGOOGOEOOORGAOR
RAOOGOOGOOOGGOOOOAOR
RAKOOUOOOOGOOOOOOAUR
RAAAAAAAAAAURRRRRRRR
RRRRRRRRRRRRRRRRRRRR