AAAAAAAAAAAAAA
AAAAAAAAAAAAAA
AAOOOOOAOOOOAA
AAOONOOAOOOOAA
AAOAGGGGOPOOAA
AAGGOOOOOOOOAA
AAOOOOSAAAOOAA
AASOSSOOOAAAAA
AAOOAOOOOOOOAA
AAGALOGOGOOOAA
AAOOAOGOGOKOAA
AAOOOOGSGOOOAA
AAAAAAAAAAAAAA
AAAAAAAAAAAAAA